[
  {
    "x": 405,
    "y": 1004
  },
  {
    "x": 339,
    "y": 1040
  },
  {
    "x": 369,
    "y": 1135
  }
]
