[
  {
    "x": 406,
    "y": 1025
  },
  {
    "x": 347,
    "y": 1063
  },
  {
    "x": 356,
    "y": 1158
  }
]
