[
  {
    "x": 785,
    "y": 240,
    "dx": 27,
    "dy": 27
  },
  {
    "x": 832,
    "y": 139,
    "dx": 27,
    "dy": 27
  },
  {
    "x": 638,
    "y": 160,
    "dx": 27,
    "dy": 27
  },
  {
    "x": 929,
    "y": 275,
    "dx": 27,
    "dy": 27
  },
  {
    "x": 926,
    "y": 218,
    "dx": 27,
    "dy": 27
  },
  {
    "x": 942,
    "y": 121,
    "dx": 27,
    "dy": 27
  },
  {
    "x": 1068,
    "y": 273,
    "dx": 27,
    "dy": 27
  }
]
