[
  {
    "x": 235,
    "y": 1330
  },
  {
    "x": 314,
    "y": 1221
  },
  {
    "x": 343,
    "y": 1328
  },
  {
    "x": 382,
    "y": 1439
  },
  {
    "x": 448,
    "y": 1312
  },
  {
    "x": 516,
    "y": 1395
  },
  {
    "x": 474,
    "y": 1211
  },
  {
    "x": 378,
    "y": 1124
  },
  {
    "x": 541,
    "y": 1124
  },
  {
    "x": 562,
    "y": 1272
  },
  {
    "x": 666,
    "y": 1365
  },
  {
    "x": 669,
    "y": 1260
  },
  {
    "x": 798,
    "y": 1193
  },
  {
    "x": 664,
    "y": 1078
  },
  {
    "x": 717,
    "y": 1165
  }
]
