[
  {
    "x": 202,
    "y": 1168
  },
  {
    "x": 174,
    "y": 1325
  },
  {
    "x": 285,
    "y": 1120
  },
  {
    "x": 265,
    "y": 1144
  },
  {
    "x": 326,
    "y": 1472
  },
  {
    "x": 446,
    "y": 1474
  },
  {
    "x": 522,
    "y": 1441
  },
  {
    "x": 565,
    "y": 1436
  },
  {
    "x": 319,
    "y": 1056
  },
  {
    "x": 430,
    "y": 1042
  },
  {
    "x": 512,
    "y": 1038
  },
  {
    "x": 578,
    "y": 1044
  },
  {
    "x": 554,
    "y": 1328
  },
  {
    "x": 572,
    "y": 1328
  },
  {
    "x": 649,
    "y": 1416
  },
  {
    "x": 607,
    "y": 1424
  },
  {
    "x": 734,
    "y": 1237
  },
  {
    "x": 735,
    "y": 1259
  },
  {
    "x": 798,
    "y": 1308
  },
  {
    "x": 838,
    "y": 1228
  },
  {
    "x": 707,
    "y": 1027
  },
  {
    "x": 656,
    "y": 1007
  },
  {
    "x": 765,
    "y": 1192
  },
  {
    "x": 750,
    "y": 1219
  }
]
