[
  {
    "x": 778,
    "y": 622,
    "dx": 28,
    "dy": 28
  },
  {
    "x": 943,
    "y": 468,
    "dx": 28,
    "dy": 28
  },
  {
    "x": 851,
    "y": 431,
    "dx": 28,
    "dy": 28
  },
  {
    "x": 663,
    "y": 560,
    "dx": 28,
    "dy": 28
  },
  {
    "x": 604,
    "y": 545,
    "dx": 28,
    "dy": 28
  },
  {
    "x": 652,
    "y": 344,
    "dx": 30,
    "dy": 30
  },
  {
    "x": 754,
    "y": 375,
    "dx": 30,
    "dy": 30
  },
  {
    "x": 831,
    "y": 523,
    "dx": 30,
    "dy": 30
  },
  {
    "x": 921,
    "y": 516,
    "dx": 30,
    "dy": 30
  }
]
