[
  {
    "x": 211,
    "y": 495,
    "dx": 25,
    "dy": 25
  },
  {
    "x": 404,
    "y": 484,
    "dx": 25,
    "dy": 25
  },
  {
    "x": 292,
    "y": 490,
    "dx": 25,
    "dy": 25
  },
  {
    "x": 338,
    "y": 622,
    "dx": 17,
    "dy": 17
  },
  {
    "x": 305,
    "y": 645,
    "dx": 25,
    "dy": 25
  },
  {
    "x": 423,
    "y": 599,
    "dx": 21,
    "dy": 21
  },
  {
    "x": 299,
    "y": 681,
    "dx": 19,
    "dy": 19
  }
]
