[
  {
    "x": 207,
    "y": 329,
    "dx": 30,
    "dy": 30
  },
  {
    "x": 286,
    "y": 232,
    "dx": 30,
    "dy": 30
  },
  {
    "x": 417,
    "y": 237,
    "dx": 30,
    "dy": 30
  },
  {
    "x": 428,
    "y": 324,
    "dx": 30,
    "dy": 30
  },
  {
    "x": 309,
    "y": 293,
    "dx": 22,
    "dy": 22
  },
  {
    "x": 346,
    "y": 198,
    "dx": 30,
    "dy": 30
  },
  {
    "x": 256,
    "y": 338,
    "dx": 23,
    "dy": 23
  },
  {
    "x": 348,
    "y": 353,
    "dx": 23,
    "dy": 23
  }
]
