[
  {
    "x": 443,
    "y": 1004
  },
  {
    "x": 364,
    "y": 1049
  },
  {
    "x": 418,
    "y": 1120
  }
]
