[
  {
    "x": 480,
    "y": 940
  },
  {
    "x": 507,
    "y": 1013
  },
  {
    "x": 318,
    "y": 952
  },
  {
    "x": 316,
    "y": 1015
  },
  {
    "x": 457,
    "y": 1128
  },
  {
    "x": 373,
    "y": 1223
  }
]