[
  {
    "x": 1080,
    "y": 1114
  },
  {
    "x": 782,
    "y": 1102
  },
  {
    "x": 945,
    "y": 1067
  },
  {
    "x": 872,
    "y": 1170
  }
]
