[
  {
    "x": 418,
    "y": 285,
    "dx": 35,
    "dy": 35
  },
  {
    "x": 263,
    "y": 405,
    "dx": 35,
    "dy": 35
  },
  {
    "x": 193,
    "y": 288,
    "dx": 35,
    "dy": 35
  }
]
