[
  {
    "x": 570,
    "y": 610,
    "dx": 28,
    "dy": 28
  },
  {
    "x": 991,
    "y": 447,
    "dx": 28,
    "dy": 28
  },
  {
    "x": 812,
    "y": 431,
    "dx": 28,
    "dy": 28
  },
  {
    "x": 725,
    "y": 488,
    "dx": 28,
    "dy": 28
  },
  {
    "x": 558,
    "y": 492,
    "dx": 28,
    "dy": 28
  },
  {
    "x": 611,
    "y": 397,
    "dx": 28,
    "dy": 28
  },
  {
    "x": 710,
    "y": 349,
    "dx": 28,
    "dy": 28
  },
  {
    "x": 773,
    "y": 518,
    "dx": 28,
    "dy": 28
  },
  {
    "x": 879,
    "y": 518,
    "dx": 28,
    "dy": 28
  }
]
