[
  {
    "x": 577,
    "y": 814,
    "dx": 27,
    "dy": 27
  },
  {
    "x": 512,
    "y": 626,
    "dx": 27,
    "dy": 27
  },
  {
    "x": 465,
    "y": 614,
    "dx": 27,
    "dy": 27
  },
  {
    "x": 331,
    "y": 726,
    "dx": 27,
    "dy": 27
  },
  {
    "x": 471,
    "y": 814,
    "dx": 27,
    "dy": 27
  }
]
