[
  {
    "x": 586,
    "y": 776,
    "dx": 27,
    "dy": 27
  },
  {
    "x": 547,
    "y": 727,
    "dx": 27,
    "dy": 27
  },
  {
    "x": 373,
    "y": 705,
    "dx": 27,
    "dy": 27
  },
  {
    "x": 410,
    "y": 738,
    "dx": 27,
    "dy": 27
  },
  {
    "x": 437,
    "y": 792,
    "dx": 27,
    "dy": 27
  }
]
