[
  {
    "x": 616,
    "y": 774,
    "dx": 25,
    "dy": 25
  },
  {
    "x": 514,
    "y": 660,
    "dx": 25,
    "dy": 25
  },
  {
    "x": 472,
    "y": 699,
    "dx": 25,
    "dy": 25
  },
  {
    "x": 387,
    "y": 784,
    "dx": 22,
    "dy": 22
  },
  {
    "x": 401,
    "y": 816,
    "dx": 27,
    "dy": 27
  }
]
