[
  {
    "x": 204,
    "y": 250,
    "dx": 28,
    "dy": 28
  },
  {
    "x": 278,
    "y": 160,
    "dx": 28,
    "dy": 28
  },
  {
    "x": 395,
    "y": 147,
    "dx": 28,
    "dy": 28
  },
  {
    "x": 459,
    "y": 232,
    "dx": 28,
    "dy": 28
  },
  {
    "x": 334,
    "y": 271,
    "dx": 23,
    "dy": 23
  },
  {
    "x": 333,
    "y": 139,
    "dx": 27,
    "dy": 27
  },
  {
    "x": 279,
    "y": 327,
    "dx": 23,
    "dy": 23
  },
  {
    "x": 322,
    "y": 353,
    "dx": 23,
    "dy": 23
  }
]
