[
  {
    "x": 238,
    "y": 250,
    "dx": 28,
    "dy": 28
  },
  {
    "x": 251,
    "y": 170,
    "dx": 22,
    "dy": 22
  },
  {
    "x": 432,
    "y": 173,
    "dx": 22,
    "dy": 22
  },
  {
    "x": 437,
    "y": 297,
    "dx": 25,
    "dy": 25
  },
  {
    "x": 347,
    "y": 297,
    "dx": 21,
    "dy": 21
  },
  {
    "x": 390,
    "y": 287,
    "dx": 25,
    "dy": 25
  },
  {
    "x": 278,
    "y": 402,
    "dx": 20,
    "dy": 20
  },
  {
    "x": 314,
    "y": 402,
    "dx": 20,
    "dy": 20
  }
]
