[
  {
    "x": 172,
    "y": 444,
    "dx": 28,
    "dy": 28
  },
  {
    "x": 371,
    "y": 518,
    "dx": 28,
    "dy": 28
  },
  {
    "x": 320,
    "y": 486,
    "dx": 28,
    "dy": 28
  },
  {
    "x": 305,
    "y": 558,
    "dx": 28,
    "dy": 28
  },
  {
    "x": 239,
    "y": 613,
    "dx": 28,
    "dy": 28
  },
  {
    "x": 446,
    "y": 598,
    "dx": 28,
    "dy": 28
  },
  {
    "x": 333,
    "y": 679,
    "dx": 20,
    "dy": 20
  }
]
