[
  {
    "x": 194,
    "y": 520,
    "dx": 27,
    "dy": 27
  },
  {
    "x": 409,
    "y": 519,
    "dx": 27,
    "dy": 27
  },
  {
    "x": 262,
    "y": 492,
    "dx": 24,
    "dy": 24
  },
  {
    "x": 347,
    "y": 581,
    "dx": 24,
    "dy": 24
  },
  {
    "x": 272,
    "y": 643,
    "dx": 27,
    "dy": 27
  },
  {
    "x": 419,
    "y": 628,
    "dx": 23,
    "dy": 23
  },
  {
    "x": 250,
    "y": 679,
    "dx": 21,
    "dy": 21
  }
]
