[
  {
    "x": 714,
    "y": 588,
    "dx": 28,
    "dy": 28
  },
  {
    "x": 986,
    "y": 484,
    "dx": 28,
    "dy": 28
  },
  {
    "x": 884,
    "y": 434,
    "dx": 25,
    "dy": 25
  },
  {
    "x": 677,
    "y": 492,
    "dx": 27,
    "dy": 27
  },
  {
    "x": 613,
    "y": 496,
    "dx": 27,
    "dy": 27
  },
  {
    "x": 656,
    "y": 395,
    "dx": 27,
    "dy": 27
  },
  {
    "x": 713,
    "y": 385,
    "dx": 25,
    "dy": 25
  },
  {
    "x": 803,
    "y": 532,
    "dx": 25,
    "dy": 25
  },
  {
    "x": 856,
    "y": 601,
    "dx": 25,
    "dy": 25
  }
]
