[
  {
    "x": 803,
    "y": 813,
    "dx": 27,
    "dy": 27
  },
  {
    "x": 893,
    "y": 908,
    "dx": 27,
    "dy": 27
  },
  {
    "x": 946,
    "y": 876,
    "dx": 27,
    "dy": 27
  }
]
