[
  {
    "x": 809,
    "y": 880,
    "dx": 25,
    "dy": 25
  },
  {
    "x": 836,
    "y": 947,
    "dx": 27,
    "dy": 27
  },
  {
    "x": 960,
    "y": 963,
    "dx": 30,
    "dy": 30
  }
]
