[
  {
    "x": 833,
    "y": 815,
    "dx": 25,
    "dy": 25
  },
  {
    "x": 871,
    "y": 947,
    "dx": 25,
    "dy": 25
  },
  {
    "x": 966,
    "y": 917,
    "dx": 30,
    "dy": 30
  }
]
