[
  {
    "x": 244,
    "y": 863,
    "dx": 25,
    "dy": 25
  },
  {
    "x": 449,
    "y": 703,
    "dx": 25,
    "dy": 25
  },
  {
    "x": 241,
    "y": 779,
    "dx": 25,
    "dy": 25
  },
  {
    "x": 569,
    "y": 709,
    "dx": 25,
    "dy": 25
  },
  {
    "x": 481,
    "y": 804,
    "dx": 25,
    "dy": 25
  },
  {
    "x": 379,
    "y": 773,
    "dx": 22,
    "dy": 22
  },
  {
    "x": 341,
    "y": 798,
    "dx": 19,
    "dy": 19
  }
]
