[
  {
    "x": 317,
    "y": 936,
    "dx": 24,
    "dy": 24
  },
  {
    "x": 411,
    "y": 706,
    "dx": 27,
    "dy": 27
  },
  {
    "x": 316,
    "y": 821,
    "dx": 21,
    "dy": 21
  },
  {
    "x": 525,
    "y": 770,
    "dx": 25,
    "dy": 25
  },
  {
    "x": 450,
    "y": 912,
    "dx": 25,
    "dy": 25
  },
  {
    "x": 430,
    "y": 808,
    "dx": 19,
    "dy": 19
  },
  {
    "x": 449,
    "y": 834,
    "dx": 19,
    "dy": 19
  }
]
