[
  {
    "x": 155,
    "y": 547,
    "dx": 22,
    "dy": 22
  },
  {
    "x": 186,
    "y": 759,
    "dx": 22,
    "dy": 22
  },
  {
    "x": 340,
    "y": 547,
    "dx": 22,
    "dy": 22
  },
  {
    "x": 472,
    "y": 749,
    "dx": 22,
    "dy": 22
  },
  {
    "x": 699,
    "y": 855,
    "dx": 22,
    "dy": 22
  },
  {
    "x": 325,
    "y": 743,
    "dx": 22,
    "dy": 22
  }
]
