[
  {
    "x": 122,
    "y": 504,
    "dx": 28,
    "dy": 28
  },
  {
    "x": 248,
    "y": 754,
    "dx": 28,
    "dy": 28
  },
  {
    "x": 411,
    "y": 546,
    "dx": 28,
    "dy": 28
  },
  {
    "x": 597,
    "y": 794,
    "dx": 28,
    "dy": 28
  },
  {
    "x": 697,
    "y": 892,
    "dx": 28,
    "dy": 28
  },
  {
    "x": 347,
    "y": 816,
    "dx": 28,
    "dy": 28
  }
]
