[
  {
    "x": 603,
    "y": 222,
    "dx": 25,
    "dy": 25
  },
  {
    "x": 731,
    "y": 108,
    "dx": 25,
    "dy": 25
  },
  {
    "x": 606,
    "y": 163,
    "dx": 25,
    "dy": 25
  },
  {
    "x": 970,
    "y": 242,
    "dx": 25,
    "dy": 25
  },
  {
    "x": 889,
    "y": 184,
    "dx": 25,
    "dy": 25
  },
  {
    "x": 911,
    "y": 122,
    "dx": 25,
    "dy": 25
  },
  {
    "x": 1068,
    "y": 211,
    "dx": 25,
    "dy": 25
  }
]
