[
  {
    "x": 546,
    "y": 1267
  },
  {
    "x": 575,
    "y": 1331
  },
  {
    "x": 380,
    "y": 1271
  },
  {
    "x": 475,
    "y": 1193
  },
  {
    "x": 603,
    "y": 1469
  },
  {
    "x": 575,
    "y": 1407
  }
]