[
  {
    "x": 155,
    "y": 547,
    "dx": 22,
    "dy": 22
  },
  {
    "x": 237,
    "y": 722,
    "dx": 35,
    "dy": 35
  },
  {
    "x": 332,
    "y": 545,
    "dx": 35,
    "dy": 35
  },
  {
    "x": 458,
    "y": 732,
    "dx": 35,
    "dy": 35
  },
  {
    "x": 430,
    "y": 909,
    "dx": 35,
    "dy": 35
  },
  {
    "x": 313,
    "y": 780,
    "dx": 35,
    "dy": 35
  }
]
