[
  {
    "x": 122,
    "y": 504,
    "dx": 28,
    "dy": 28
  },
  {
    "x": 222,
    "y": 841,
    "dx": 35,
    "dy": 35
  },
  {
    "x": 453,
    "y": 590,
    "dx": 35,
    "dy": 35
  },
  {
    "x": 528,
    "y": 799,
    "dx": 35,
    "dy": 35
  },
  {
    "x": 692,
    "y": 847,
    "dx": 35,
    "dy": 35
  },
  {
    "x": 357,
    "y": 844,
    "dx": 35,
    "dy": 35
  }
]
