[
  {
    "x": 88,
    "y": 546,
    "dx": 25,
    "dy": 24
  },
  {
    "x": 221,
    "y": 830,
    "dx": 35,
    "dy": 28
  },
  {
    "x": 298,
    "y": 566,
    "dx": 35,
    "dy": 28
  },
  {
    "x": 501,
    "y": 745,
    "dx": 35,
    "dy": 28
  },
  {
    "x": 498,
    "y": 895,
    "dx": 35,
    "dy": 28
  },
  {
    "x": 386,
    "y": 792,
    "dx": 35,
    "dy": 28
  }
]
