[
  {
    "x": 88,
    "y": 546,
    "dx": 25,
    "dy": 24
  },
  {
    "x": 178,
    "y": 742,
    "dx": 35,
    "dy": 35
  },
  {
    "x": 420,
    "y": 547,
    "dx": 35,
    "dy": 35
  },
  {
    "x": 482,
    "y": 828,
    "dx": 35,
    "dy": 35
  },
  {
    "x": 500,
    "y": 889,
    "dx": 35,
    "dy": 35
  },
  {
    "x": 372,
    "y": 780,
    "dx": 35,
    "dy": 35
  }
]
