[
  {
    "x": 287,
    "y": 255,
    "dx": 36,
    "dy": 36
  },
  {
    "x": 206,
    "y": 443,
    "dx": 36,
    "dy": 36
  },
  {
    "x": 175,
    "y": 337,
    "dx": 36,
    "dy": 36
  }
]
