[
  {
    "x": 275,
    "y": 863,
    "dx": 26,
    "dy": 26
  },
  {
    "x": 398,
    "y": 736,
    "dx": 26,
    "dy": 26
  },
  {
    "x": 288,
    "y": 822,
    "dx": 26,
    "dy": 26
  },
  {
    "x": 499,
    "y": 718,
    "dx": 26,
    "dy": 26
  },
  {
    "x": 483,
    "y": 842,
    "dx": 26,
    "dy": 26
  },
  {
    "x": 416,
    "y": 773,
    "dx": 22,
    "dy": 22
  },
  {
    "x": 347,
    "y": 825,
    "dx": 21,
    "dy": 21
  }
]
