[
  {
    "x": 911,
    "y": 630,
    "dx": 37,
    "dy": 37
  },
  {
    "x": 894,
    "y": 821,
    "dx": 37,
    "dy": 37
  },
  {
    "x": 995,
    "y": 865,
    "dx": 37,
    "dy": 37
  }
]
