[
  {
    "x": 346,
    "y": 116,
    "dx": 25,
    "dy": 25
  },
  {
    "x": 320,
    "y": 397,
    "dx": 25,
    "dy": 25
  },
  {
    "x": 207,
    "y": 312,
    "dx": 25,
    "dy": 25
  },
  {
    "x": 265,
    "y": 221,
    "dx": 25,
    "dy": 25
  },
  {
    "x": 348,
    "y": 292,
    "dx": 25,
    "dy": 25
  },
  {
    "x": 417,
    "y": 260,
    "dx": 25,
    "dy": 25
  },
  {
    "x": 457,
    "y": 383,
    "dx": 25,
    "dy": 25
  },
  {
    "x": 531,
    "y": 200,
    "dx": 25,
    "dy": 25
  },
  {
    "x": 501,
    "y": 355,
    "dx": 25,
    "dy": 25
  },
  {
    "x": 581,
    "y": 445,
    "dx": 25,
    "dy": 25
  },
  {
    "x": 552,
    "y": 280,
    "dx": 25,
    "dy": 25
  },
  {
    "x": 761,
    "y": 156,
    "dx": 25,
    "dy": 25
  },
  {
    "x": 761,
    "y": 338,
    "dx": 25,
    "dy": 25
  },
  {
    "x": 787,
    "y": 250,
    "dx": 25,
    "dy": 25
  },
  {
    "x": 459,
    "y": 140,
    "dx": 25,
    "dy": 25
  },
  {
    "x": 570,
    "y": 129,
    "dx": 25,
    "dy": 25
  },
  {
    "x": 630,
    "y": 384,
    "dx": 25,
    "dy": 25
  },
  {
    "x": 653,
    "y": 300,
    "dx": 25,
    "dy": 25
  }
]
