[
  {
    "x": 308,
    "y": 122,
    "dx": 25,
    "dy": 25
  },
  {
    "x": 265,
    "y": 328,
    "dx": 25,
    "dy": 25
  },
  {
    "x": 231,
    "y": 277,
    "dx": 25,
    "dy": 25
  },
  {
    "x": 259,
    "y": 187,
    "dx": 20,
    "dy": 20
  },
  {
    "x": 348,
    "y": 318,
    "dx": 25,
    "dy": 25
  },
  {
    "x": 434,
    "y": 236,
    "dx": 25,
    "dy": 25
  },
  {
    "x": 401,
    "y": 327,
    "dx": 25,
    "dy": 25
  },
  {
    "x": 475,
    "y": 264,
    "dx": 25,
    "dy": 25
  },
  {
    "x": 514,
    "y": 328,
    "dx": 25,
    "dy": 25
  },
  {
    "x": 618,
    "y": 435,
    "dx": 25,
    "dy": 25
  },
  {
    "x": 587,
    "y": 198,
    "dx": 25,
    "dy": 25
  },
  {
    "x": 676,
    "y": 149,
    "dx": 25,
    "dy": 25
  },
  {
    "x": 775,
    "y": 308,
    "dx": 25,
    "dy": 25
  },
  {
    "x": 803,
    "y": 197,
    "dx": 25,
    "dy": 25
  },
  {
    "x": 425,
    "y": 145,
    "dx": 25,
    "dy": 25
  },
  {
    "x": 519,
    "y": 143,
    "dx": 25,
    "dy": 25
  },
  {
    "x": 554,
    "y": 330,
    "dx": 25,
    "dy": 25
  },
  {
    "x": 654,
    "y": 252,
    "dx": 25,
    "dy": 25
  }
]
