[
  {
    "x": 338,
    "y": 165,
    "dx": 20,
    "dy": 20
  },
  {
    "x": 355,
    "y": 402,
    "dx": 20,
    "dy": 20
  },
  {
    "x": 182,
    "y": 303,
    "dx": 20,
    "dy": 20
  },
  {
    "x": 243,
    "y": 164,
    "dx": 20,
    "dy": 20
  },
  {
    "x": 318,
    "y": 255,
    "dx": 20,
    "dy": 20
  },
  {
    "x": 387,
    "y": 182,
    "dx": 20,
    "dy": 20
  },
  {
    "x": 438,
    "y": 334,
    "dx": 20,
    "dy": 20
  },
  {
    "x": 513,
    "y": 264,
    "dx": 20,
    "dy": 20
  },
  {
    "x": 514,
    "y": 292,
    "dx": 20,
    "dy": 20
  },
  {
    "x": 515,
    "y": 401,
    "dx": 20,
    "dy": 20
  },
  {
    "x": 587,
    "y": 229,
    "dx": 20,
    "dy": 20
  },
  {
    "x": 728,
    "y": 168,
    "dx": 20,
    "dy": 20
  },
  {
    "x": 731,
    "y": 384,
    "dx": 20,
    "dy": 20
  },
  {
    "x": 720,
    "y": 288,
    "dx": 20,
    "dy": 20
  },
  {
    "x": 473,
    "y": 88,
    "dx": 20,
    "dy": 20
  },
  {
    "x": 634,
    "y": 93,
    "dx": 20,
    "dy": 20
  },
  {
    "x": 587,
    "y": 342,
    "dx": 20,
    "dy": 20
  },
  {
    "x": 622,
    "y": 260,
    "dx": 20,
    "dy": 20
  }
]
